+-+-+-+-+-+-+-+-+-+-+-+-+-+-+-+-+-+-+-+-+-+-+-+-+-+-+-+-+-+-+-+-+-+-+-+-+-+-+-+-+-+-+-+-+-+-+-+-+-+-+-+-+-+-+-+-+-+-+-+-+-+-+-+-+-+-+-+-+-+-+
S |     |     |           |       |                   |     |         |   |     |   |     |     |   |   |     |         |   |               |
+ + +-+ + +-+ + +-+-+-+ + + +-+-+-+ +-+-+-+ +-+-+-+-+ + +-+ + +-+-+-+ + + +-+ + + + + +-+ + +-+ +-+ + + + +-+ + + +-+-+ + + + + +-+ +-+-+-+ +
|   |   | | | |   |     | |       | |   |   |   |   |   |     |     | | | |   | | | |   | | |       | | | |   | | |     | | | |   |     |   |
+-+-+ +-+ + + +-+ + +-+-+ +-+-+-+ + + + + +-+ + + +-+-+-+-+-+-+ + + + + + + +-+ + + +-+-+ + +-+-+-+-+-+ + + +-+-+ + +-+-+ + + +-+ +-+-+ + +-+
|     |     |   | |   | |   |   |   | | |   | | |   |   |       | | |   | | |   | | |   | |       |     | |       |       |     | |     |   |
+ +-+-+ + +-+-+ +-+-+ + +-+ + + +-+-+ + +-+ + + +-+ + +-+ +-+-+-+ + +-+-+ + + +-+ + + + + +-+-+ + +-+-+ + +-+-+-+-+-+-+ +-+-+-+-+ +-+-+-+-+ +
|     | |     |       |   | | |       | | | | | | | |   | |   |   | | |   | |     |   |   |   | |     | | |     |       |         |       | |
+-+-+ +-+ +-+ +-+-+-+-+-+ + + + +-+-+ + + + + + + + +-+ + + + + +-+ + + +-+-+-+ +-+-+-+-+-+ + + +-+ + + + +-+-+ + +-+-+-+-+-+-+-+ + + +-+-+ +
|   |   |   | |   |     | |   | |   | | | | | |   |       | | |   | | |     |   |           |   |   | | |   |   |         |     |   | |     |
+ + +-+ +-+ + +-+ + +-+ + +-+-+-+ + + + + + + +-+ +-+-+ +-+ +-+-+ + + + +-+ + +-+ +-+-+-+-+-+-+-+ +-+-+ + + + +-+-+-+-+-+ + +-+ +-+-+ + +-+-+
| |     |   |       |   | | |   | | | |   | |   | |     |       | | |   |       |     |   | |     |     | | | |     |   | | | |       | |   |
+ +-+-+-+-+-+-+-+ +-+ +-+ + + + +-+ + + +-+ +-+ +-+ + +-+-+-+-+ + + +-+-+ +-+-+-+-+-+ +-+ + + +-+-+ +-+-+-+ + + +-+ + + + + + +-+-+-+-+ + + +
|     |       | | | |     | | | |   | |       |     | |       |   |     |   | |   |     | |   |   | |   |   | | |     | | | | |       |   | |
+ +-+ + +-+-+ + + + +-+-+-+ + + + +-+ +-+-+-+-+-+-+-+ + +-+-+ +-+-+-+-+ +-+ + + + + +-+ + + +-+-+ + + + + +-+ +-+ +-+-+-+ + + + +-+-+-+-+-+ +
| |   |     | | | |   |   |   |   |   |             | | |   | |       |     |   | |   | |   |       | |     |   |         | | |     |       |
+ + +-+-+-+ + + + +-+ + + +-+ +-+-+ + + +-+-+-+-+-+ + + + + + + +-+-+ + +-+-+-+-+ +-+ + +-+-+ +-+ + + +-+-+-+-+ +-+-+-+-+-+ + +-+-+ + +-+-+-+
| | |     | |   |     | |   | |   | |   |   |     | |   | | |   |     |     |   |   | |   |   | | | |         |     |   |   |     |   |   | |
+ + + +-+ + +-+ +-+-+ + + + + + + + +-+-+ + + +-+ + +-+-+ +-+-+-+ +-+-+-+-+ + + +-+ +-+ +-+ +-+ + + +-+-+ +-+ +-+-+ + + + + + +-+-+-+-+ + + +
| |   |   |   |     | | | |   | | |   |   |   | |   |   |       | | |     | | | |       |   | |   |     | |   |     | | | |   |         |   |
+-+-+-+ +-+-+ +-+ +-+ + + +-+-+ + +-+ +-+-+-+-+ +-+-+-+ +-+-+-+ + + + +-+ + + + + + + +-+ +-+ + +-+-+-+ +-+ +-+ +-+-+ + + +-+ + +-+-+-+-+-+-+
|       |   |   |   | | |       |     |       |   |   |       |     | |   | | |   | |   | | |   |     | |       |   | | | |   | |   |   |   |
+ +-+-+-+ + +-+ +-+ +-+ +-+-+-+-+-+-+-+ +-+ + +-+ + + +-+ +-+ +-+-+-+ + +-+ + +-+-+ +-+-+ + +-+ +-+-+ +-+ + +-+-+ + + +-+ +-+-+ + + +-+ +-+ +
|       | | |   |   |   |       | |   | | | |       | |   |   |       |   |   |   |     | |           |   |     | |     |     |   |   | |   |
+-+ +-+ + + +-+-+ +-+ +-+ +-+ + + + + + + + +-+-+-+-+ + +-+ +-+ +-+-+-+ +-+-+-+ +-+-+-+ + +-+-+-+-+ +-+ +-+-+-+ +-+-+ + +-+-+ +-+-+-+ + + +-+
|   |   | | |   |     | |   | |   | |   |   |       | | |     | |     | |               | |   |   |   |   |   | |   | |     |   |       | | |
+-+-+ +-+ + + + + +-+-+ +-+ + +-+-+ +-+-+-+-+ +-+-+ + +-+ + +-+ + +-+-+ + +-+-+-+-+-+-+ + + + +-+ +-+-+-+ + + + + + + +-+-+ +-+ + +-+ +-+ + +
|   | |   | | | |   |   | | | | |   |       |   | |   |   | |   |     | | |   |       | | | | |     |   | | | | | | | |   |     |   |   |   |
+ + + + +-+ + + + + + +-+ + + + + +-+-+-+-+ +-+ + +-+-+ + + + +-+-+-+ + + + + + +-+-+ + + + + + + + + + + + +-+ + + + + + +-+-+-+-+-+-+ + +-+
| | | |   | | | | |   |   | |     |   |     |     |     | | | |         | | | | |   | | | | | | | |   |   |     | | |   |     |     | | |   |
+ + + +-+ + + + + +-+-+ + + +-+-+-+ + + +-+-+ + + + +-+-+-+ + +-+-+-+-+-+ + + + + + + + + + + + +-+-+-+ + +-+-+-+ + +-+-+-+-+ +-+-+ + + +-+ +
| |   |   | | | |   |   |   |   |   |   |     | | | |   |   |   |       | | |   | | | |   | |   |       |   |   | | |       | |   | |   |   |
+ +-+-+ +-+ + + +-+ + +-+-+-+ + + +-+-+-+ +-+-+ +-+ + +-+ +-+-+ + +-+-+ + + +-+-+ +-+ +-+-+-+ +-+ +-+-+-+-+ + + +-+ + +-+-+ + + + + + +-+ + +
|   |   |     | |   |     |   |   |   | |   | |     |     |     |   |   |   |   |     |   |   |   | |     | | |     |   |   | | | | | |   | |
+-+ + + +-+-+-+ + +-+-+-+ +-+ + +-+ + + +-+ + +-+-+-+-+ +-+ +-+-+-+ + +-+-+-+-+ +-+-+-+ + + +-+-+-+ + + +-+ + +-+-+ +-+ + +-+ + + + + + +-+ +
|   | | |       | |     |   | | |   |     | | |   |   |     |     | | |         |   |   | |     | | | |     | |   |     | |   | | | | |   | |
+ +-+-+ + +-+-+-+ +-+-+ +-+ +-+ + + +-+-+ + + +-+ + + +-+-+-+ +-+-+ + +-+ +-+-+-+ + +-+-+ +-+-+ + + + +-+-+-+ + +-+-+ +-+ + +-+ + + + +-+ +-+
| |     |   |     |             | | |   |   |   |   |   |     |     |   |       | |       | |   |     |       |     | |   |     |   |   |   |
+ + +-+-+-+ + +-+-+ +-+-+-+-+-+-+ +-+ + +-+-+-+ + +-+-+ +-+-+ + +-+-+-+ + +-+-+ + +-+-+-+-+ + +-+-+-+-+ +-+-+-+-+-+ +-+ +-+-+-+-+-+-+ + +-+ +
| |     |   |     |       |   |     | |       | |   | | |   |     |     | |             |     |   |     |     |     |   |       |   | |     |
+ + +-+-+ +-+-+ +-+-+-+-+ +-+ + +-+ + + +-+-+ + +-+ + + + + +-+ + + +-+-+ +-+-+ + +-+-+ + + +-+ + + + + +-+-+ + + + + +-+ +-+-+ + + + +-+ +-+
| | |   | |   | |   |         | |   | | |   |   |   |     |   | | |     | |   | |     |   |   | |   | |       | | | | |   |     | | |   |   |
+ + + + + + + + + + +-+ +-+-+-+ +-+-+ +-+ + +-+-+ +-+-+ +-+-+ +-+ +-+ +-+ + + + +-+-+ +-+-+-+ + +-+-+ +-+-+ +-+-+ + + + +-+ +-+-+ + +-+ +-+-+
|   | |   | |   | |   | |   | |     |     | |     |     |   |   |   |   |   | |   |     |   |   |   |     | |     | |   |   | |   |     |   |
+ +-+ +-+-+ +-+-+ +-+ + +-+ + +-+ +-+-+-+-+ + +-+-+ +-+-+ +-+-+ + + +-+ +-+-+-+-+ +-+-+ +-+ +-+-+-+ +-+ +-+ + +-+-+ +-+-+-+ + + +-+ +-+-+ + +
| | | |     |   | |   |   | |     |   |     |   |   |   | |     | |   |   | |   |   |     |       |   | |   | |     |   |     |   |       | |
+ + + + +-+-+ + +-+ +-+-+ + + + +-+ + + +-+-+-+ + +-+ + + + +-+-+ +-+ +-+ + + +-+-+ +-+-+ +-+-+-+ +-+ + + +-+ +-+ +-+ + + +-+-+-+ +-+-+-+-+ +
| | |   |   | |           | | |   | | |     | | | | | |   | |     | | |   | |     |   | |   |   | | |   |   |   | |   | |     |   |   |     |
+ + + +-+ + + +-+ + +-+-+-+ + +-+-+ + +-+ + + + + + + +-+-+ + +-+-+ + + +-+ +-+ +-+-+ + + + + + + + +-+-+-+ +-+ + +-+ + +-+-+ +-+ + +-+ +-+-+
|   |     |   |   |         |       |     |     |         |   |       |               |   |   |   |             |     |     |     |         F
+-+-+-+-+-+-+-+-+-+-+-+-+-+-+-+-+-+-+-+-+-+-+-+-+-+-+-+-+-+-+-+-+-+-+-+-+-+-+-+-+-+-+-+-+-+-+-+-+-+-+-+-+-+-+-+-+-+-+-+-+-+-+-+-+-+-+-+-+-+-+
